NO cub3D-tester/textures/test/north.xpm
SO cub3D-tester/textures/test/south.xpm
WE cub3D-tester/textures/test/west.xpm
EA cub3D-tester/textures/test/east.xpm

F 50,50,50
C 100,100,100

11111111
100000011
1110000001
10000000011
100000N0001
11100111111
   00
   11
