NO ./north.xpm
SO ./south.xpm
EA	./east.xpm
WE	./west.xpm

F 50,50,50
C 100,100,100

11111111
100000011
1110000000001
10000000000011
100000N0001
11111111111
