NO north.xpm
SO south.xpm
EA east.xpm
WE west.xpm
F 0, 0, 0
C 80, 80, 80

11111111111
10000000001    1111111
1000000000111111000001    111111
100N000000000000000001    100001
1111111111111111111111    111111
